10|12|140
10|13|137
10|14|32
11|12|150
11|13|194
11|14|129
12|12|206
12|13|154
12|14|131
